     MMMMMMM
     MM    M
MMMMMMM     MMMMMMMM
MMMMMMMMMB MMMMMMMMM
M H    MMs MM      M
M v    MMpMM       R
bhh GGGG           M
M                  M
MMMMMMMMMMPMMMMMMMMM
MMMMMMMMMMOMMMMMMMMM
