     MMMMMMM
     MMMMMMM
MMMMMMMM  MMMMMMMMMM
MMMMMMMM  MMMMMMMMMM
M H                M
M     B          GGM
M           MMMMMMMM
MMMMMMMMMM  MMMMMMMM
MMMMMMMMMM OMMM
      MMMMMMMM
