    MMMMMMMMMMMMMMMM
    MMMM          MM
MMMMMMMM          MM
MMMMMMMM          MM
MM H    hhhv      MM
MM    B    v      MM
MMMMMM     hhh    MM
    MM            MM
    MM           OMM
    MMMMMMMMMMMMMMMM