MMMMMMMMMMMMMMMMMMMM
M                  M
M  H               M
M           s  B   R
M              s   M            
M    B         O   M             
M                  M  
M    O             M
M                  M
MMMMMMMMMMMMMMMMMMMM
